fiscalDateEnding,reportedCurrency,totalAssets,totalCurrentAssets,cashAndCashEquivalentsAtCarryingValue,cashAndShortTermInvestments,inventory,currentNetReceivables,totalNonCurrentAssets,propertyPlantEquipment,accumulatedDepreciationAmortizationPPE,intangibleAssets,intangibleAssetsExcludingGoodwill,goodwill,investments,longTermInvestments,shortTermInvestments,otherCurrentAssets,otherNonCurrentAssets,totalLiabilities,totalCurrentLiabilities,currentAccountsPayable,deferredRevenue,currentDebt,shortTermDebt,totalNonCurrentLiabilities,capitalLeaseObligations,longTermDebt,currentLongTermDebt,longTermDebtNoncurrent,shortLongTermDebtTotal,otherCurrentLiabilities,otherNonCurrentLiabilities,totalShareholderEquity,treasuryStock,retainedEarnings,commonStock,commonStockSharesOutstanding,ticker
2024-09-30,USD,6023500000,2348000000,284100000,284900000,1464700000,500800000,6057500000,1278300000,1199400000,1999600000,939900000,1059700000,33700000,32900000,800000,97600000,2397200000,3989200000,1194100000,369100000,201400000,199200000,195000000,2795100000,144100000,2602300000,199200000,2372700000,2571900000,648700000,217300000,2034300000,2137800000,3724900000,76900000,66101000,BC
2024-06-30,USD,6395700000,2728100000,494500000,577000000,1524200000,530000000,6017600000,1300300000,1176900000,1972200000,948100000,1024100000,120000000,37500000,82500000,96900000,2367300000,4382100000,1608100000,447900000,198200000,454700000,454700000,2774000000,135800000,2858300000,454700000,2372400000,2827100000,730100000,204800000,2013600000,2118000000,3708100000,76900000,66352000,BC
2024-03-31,USD,6508700000,2807200000,548400000,549200000,1555000000,616800000,6077900000,1309000000,1153800000,1990600000,964300000,1026300000,42200000,41400000,800000,86200000,2392500000,4459100000,1673800000,513800000,198400000,455400000,455400000,2785300000,140700000,2859100000,455400000,2371900000,2827300000,704400001,210900000,2049600000,2010800000,3636300000,76900000,67689000,BC
2023-12-31,USD,6230500000,2509700000,467800000,479700000,1476800000,493200000,6084000000,1315800000,1135500000,2008700000,978000000,1030700000,16300000,15500000,11900000,71100000,2405000000,4143100000,1752100000,558000000,73700000,454700000,0,2391000000,162200000,2462900000,454700000,1975700000,2430400000,627200000,216500000,2087400000,1952700000,3596900000,76900000,68227000,BC
2023-09-30,USD,6100900000,2441300000,330900000,331700000,1445000000,568200000,5989700000,1311600000,1111000000,2007400000,999800000,1007600000,36400000,35600000,800000,85300000,2348000000,4015100000,1659200000,493400000,193600000,455300000,455300000,2355900000,117800000,2460500000,455300000,1975700000,2431000000,696500000,204400000,2085800000,1897600000,3563400000,76900000,68939000,BC
2023-06-30,USD,6290100000,2672800000,477500000,478300000,1484200000,614500000,5902200000,1314100000,1094600000,1954000000,979400000,974600000,60800000,60000000,800000,84800000,2303200000,4188700000,1394000000,549400000,194600000,88300000,88300000,2794700000,105400000,2540500000,88300000,2422000000,2510300000,756300000,207500000,2101400000,1809200000,3478700000,76900000,70005000,BC
2023-03-31,USD,6288600000,2678400000,387800000,388600000,1506000000,698000000,5909000000,1293500000,1074200000,1966400000,992400000,974000000,62300000,61500000,800000,74700000,2316700000,4226100000,1438600000,594000000,None,89800000,89800000,2787500000,106300000,2541200000,89800000,2420500000,2510300000,752300000,200000000,2062500000,1736800000,3372300000,76900000,70891000,BC
2022-12-31,USD,6321300000,2695200000,595600000,613000000,1471400000,543000000,5963200000,1270800000,1051400000,1965000000,997400000,967600000,58500000,54000000,17400000,67800000,2355300000,4279000000,1489900000,662600000,70300000,89000000,3700000,2789100000,125600000,2544700000,89000000,2420000000,2509000000,668000000,161100000,2042300000,1684900000,3288500000,76900000,71365000,BC
2022-09-30,USD,6124900000,2595000000,457400000,491900000,1429800000,557700000,5794300000,1221100000,1031000000,1967600000,1005400000,962200000,82200000,47700000,34500000,103900000,2308800000,4123900000,1379300000,631600000,None,84900000,84900000,2744600000,95700000,2536200000,84900000,2419100000,2504000000,658800000,164500000,2001000000,1595200000,3173000000,76900000,72612000,BC
2022-06-30,USD,6166500000,2685400000,566700000,603700000,1372400000,611000000,5765600000,1164400000,1016100000,2004900000,1038200000,966700000,85000000,48000000,37000000,98299999,2316700000,4161900000,1347700000,644000000,None,3000000,3000000,2814200000,86100000,2534900000,3000000,2499000000,2502000000,700700000,162400000,2004600000,1455400000,3036200000,76900000,74472000,BC
2022-03-31,USD,6093000000,2791200000,680100000,686900000,1345700000,664700000,5508000000,1078100000,1002300000,1927800000,1038400000,889400000,54900000,48100000,6800000,81700000,2223700000,4113100000,1328200000,660000000,None,2300000,2300000,2784900000,72200000,2534100000,2300000,2498200000,2500500000,663500000,146100000,1979900000,1316200000,2866300000,76900000,76338000,BC
2021-12-31,USD,5425000000,2124600000,354500000,367500000,1208000000,485300000,5523500000,1046900000,989600000,1940500000,1052100000,888400000,44600000,43800000,13000000,63800000,2253500000,3510800000,1442200000,693500000,61400000,37400000,0,2068600000,101300000,1845200000,37400000,1779000000,1816400000,649900000,144500000,1914200000,1245800000,2720100000,76900000,76933000,BC
2021-09-30,USD,5180600000,2942000000,1486400000,1487200000,940500000,451100000,3488700000,961500000,982600000,993000000,549200000,443800000,42100000,41300000,800000,52300000,1277100000,3330900000,1256300000,589800000,None,43200000,43200000,2074600000,67600000,1848100000,43200000,1787700000,1830900000,611300000,148500000,1849700000,1225000000,2644500000,76900000,77134000,BC
2021-06-30,USD,4138500000,1988000000,590200000,591000000,835100000,503300000,3365600000,912000000,964500000,970600000,536300000,434300000,42200000,41400000,800000,48900000,1238500000,2369000000,1251300000,588200000,None,43500000,43500000,1117700000,69500000,895600000,43500000,832000000,875500000,610600000,144300000,1769500000,1182200000,2527200000,76900000,77554000,BC
2021-03-31,USD,3943200000,1835700000,471900000,479200000,765600000,539100000,3317900000,872400000,944900000,967000000,544300000,422700000,43600000,36300000,7300000,42100000,1235100000,2300600000,1129000000,532400000,None,43800000,43800000,1171600000,64900000,965200000,43800000,900900000,944700000,550400000,133500000,1642600000,1142400000,2374000000,76900000,77941000,BC
2020-12-31,USD,3770600000,1670500000,519600000,587000000,711800000,337600000,3322200000,863600000,929800000,970000000,552300000,417700000,89200000,32500000,67400000,34100000,1236500000,2260600000,1079200000,457600000,48200000,43100000,51200000,1181400000,89000000,973200000,43100000,908300000,951400000,530300000,128600000,1510000000,1133700000,2225700000,76900000,77875000,BC
2020-09-30,USD,3690800000,1681200000,650400000,651200000,589400000,398800000,3186700000,819100000,912900000,975900000,559600000,416300000,26300000,25500000,800000,32700000,1190500000,2232600000,949600000,392900000,None,48400000,48400000,1283000000,69300000,1061600000,48400000,1013200000,1061600000,497400000,128600000,1458200000,1095500000,2151700000,76900000,78421000,BC
2020-06-30,USD,3739100000,1714100000,541500000,542300000,676900000,452600000,3221700000,815400000,895400000,982500000,567100000,415400000,30200000,29400000,800000,30700000,1209600000,2374700000,1054600000,328300000,None,225300000,225300000,1320100000,69000000,1285700000,225300000,1060400000,1285700000,494900000,118900000,1364400000,1051200000,2032800000,76900000,79135000,BC
2020-03-31,USD,3904600000,1869800000,502900000,515300000,840100000,465400000,3247100000,810600000,877300000,989000000,575000000,414000000,32100000,31300000,12400000,49000000,1224200000,2600900000,1286200000,366800000,None,425700000,425700000,1314700000,69600000,1494700000,425700000,1069000000,1494700000,493700000,104000000,1303700000,1051800000,1981100000,76900000,79597000,BC
2019-12-31,USD,3564400000,1525800000,320300000,332700000,824500000,331800000,3149800000,796400000,863800000,998500000,583500000,415000000,30300000,29500000,12400000,36800000,1242200000,2263500000,944400000,393500000,38700000,41300000,41300000,1319100000,88500000,1109300000,41300000,1068000000,1109300000,470900000,107400000,1300900000,1023100000,1931300000,76900000,79569000,BC
2019-09-30,USD,3654400000,1693600000,366200000,378600000,810200000,414700000,3076000000,763700000,849400000,1005000000,591000000,414000000,28600000,27800000,12400000,90100000,1197100000,2236200000,904000000,347600000,None,48500000,48500000,1332200000,69700000,1131500000,48500000,1083000000,1131500000,499300000,111400000,1418200000,856200000,1883500000,76900000,82406000,BC
2019-06-30,USD,4040800000,2011400000,656100000,668500000,801800000,484500000,3152600000,747000000,836500000,1010100000,599400000,410700000,33500000,32700000,12400000,56600000,1282400000,2503500000,1015700000,412900000,None,40300000,40300000,1487800000,67100000,1280400000,40300000,1240100000,1280400000,556400000,111400000,1537300000,696600000,2140500000,76900000,85687000,BC
2019-03-31,USD,4334900000,1937800000,161500000,171400000,817300000,499200000,3810700000,703500000,805500000,959900000,578100000,381800000,39300000,38500000,9900000,91600000,1693600000,2808000000,1205700000,420600000,None,40900000,40900000,1602300000,83800000,1286500000,40900000,1245600000,1286500000,690300000,100400000,1526900000,628900000,2081100000,76900000,87063000,BC
2018-12-31,USD,4291500000,1880100000,294400000,304200000,774000000,351800000,3990800000,694500000,791900000,963100000,585800000,377300000,35400000,34600000,9800000,81600000,1716900000,2708900000,1256600000,458200000,27600000,41300000,41300000,1452300000,None,1220800000,41300000,1179500000,1220800000,603100000,267100000,1582600000,638000000,2135700000,76900000,86757000,BC
2018-09-30,USD,4222000000,1866200000,302400000,312700000,724600000,392500000,3909700000,615900000,794200000,971700000,594000000,377700000,27200000,26400000,10300000,76900000,1739900000,2663900000,1484600000,415200000,None,338800000,303800000,1179300000,None,1229800000,100000,891000000,1229800000,656400000,116700000,1558100000,638500000,2110500000,76900000,86740000,BC
2018-06-30,USD,3436700000,1891000000,435900000,446100000,641300000,412400000,2302000000,595000000,802700000,92000000,58500000,33500000,30800000,30000000,10200000,47100000,950700000,1935700000,1115200000,374600000,None,4700000,4700000,820500000,None,438800000,6800000,429000000,438800000,671500000,114400000,1501000000,635400000,2056900000,76900000,86792000,BC
2018-03-31,USD,3404600000,1862700000,284000000,294200000,903100000,623600000,2363700000,722700000,910600000,576300000,148000000,428300000,30300000,29500000,10200000,40400000,819200000,1923800000,1076400000,431000000,None,5100000,5100000,847400000,None,438800000,7700000,428900000,438800000,68000000,199600000,1480800000,599100000,1994400000,76900000,87277000,BC
2017-12-31,USD,3358200000,1846700000,448800000,459000000,827700000,None,2348600000,706000000,895800000,183000000,149100000,33900000,25800000,25000000,10200000,73100000,805500000,1875300000,1035100000,420500000,66000000,5600000,5600000,840200000,None,437400000,5600000,431800000,437400000,554600000,187600000,1482900000,575400000,1966800000,76900000,87537000,BC
2017-09-30,USD,3399200000,1776700000,391100000,402600000,848600000,476400000,2492100000,706400000,888400000,591800000,165500000,426300000,22500000,21700000,11500000,49100000,916100000,1829100000,980100000,397300000,None,4200000,4200000,849000000,None,441800000,6500000,437600000,441800000,578600000,184900000,1570100000,566500000,2100200000,76900000,87687000,BC
2017-06-30,USD,3383700000,1777800000,437200000,448700000,769300000,524600000,923700000,682200000,885400000,579300000,161700000,417600000,23300000,22500000,11500000,35200000,923700000,1835900000,985800000,393800000,None,5800000,5800000,850100000,None,443100000,445700000,438200000,443100000,586200000,178200000,1547800000,507200000,2035900000,76900000,88776000,BC
2017-03-31,USD,3273900000,1671000000,273300000,285200000,747400000,516700000,949900000,583300000,787600000,574600000,158600000,416000000,27300000,26600000,11900000,38700000,1019600000,1800300000,956500000,390300000,None,4700000,6400000,843800000,None,441300000,6400000,435400000,441300000,543300000,164500000,1473600000,471100000,1931100000,76900000,89365000,BC
2016-12-31,USD,3284700000,1688500000,422400000,469400000,699000000,411500000,950900000,569000000,777100000,573900000,160100000,413800000,56500000,20700000,47000000,39700000,1027200000,1844600000,964900000,378200000,62300000,5600000,3000000,879700000,None,439400000,5600000,433800000,442400000,502100000,162900000,1440100000,465200000,1881000000,76900000,89317000,BC
2016-09-30,USD,3241200000,1698800000,437200000,450700000,755000000,454600000,945700000,596700000,891900000,577100000,164100000,413000000,17100000,16300000,13500000,38500000,945700000,1806500000,917700000,364000000,None,4200000,4200000,888800000,None,447900000,4200000,448000000,447900000,549500000,168900000,1434700000,440200000,1878000000,76900000,89835000,BC
2016-06-30,USD,3243600000,1732900000,492800000,506000000,706800000,482100000,938100000,572600000,881000000,528100000,135000000,393100000,26500000,26000000,13200000,38000000,49400000,1855400000,930600000,366300000,None,4700000,4700000,924800000,None,447300000,4700000,447900000,447300000,559600000,168200000,1388200000,417200000,1806200000,76900000,90712000,BC
2016-03-31,USD,3122700000,1609400000,282200000,295700000,737400000,526300000,962900000,550400000,870100000,517100000,136800000,380300000,28100000,27300000,13500000,50000000,46400000,1817400000,896200000,362000000,None,4800000,4800000,921200000,None,447500000,4800000,446100000,447500000,529400000,164400000,1305300000,398100000,1711700000,76900000,90712000,BC
2015-12-31,USD,3152500000,1804400000,657300000,668800000,685000000,398100000,842900000,505200000,861400000,353800000,55100000,298700000,33000000,21500000,11500000,39800000,47400000,1871200000,908100000,339100000,None,6000000,6000000,963100000,None,448500000,6000000,442500000,448500000,505800000,160800000,1281300000,389900000,1660400000,76900000,90813000,BC
2015-09-30,USD,3127000000,1815800000,621900000,654400000,709800000,400700000,821600000,489600000,844300000,348400000,49900000,298500000,52100000,19600000,32500000,35300000,44700000,1837900000,863400000,341000000,None,4000000,4000000,974500000,None,453100000,None,449100000,453100000,518400000,195200000,1289100000,371200000,1683300000,76900000,91168000,BC
2015-06-30,USD,3100300000,1772700000,582900000,608700000,670000000,446800000,850700000,476900000,847800000,341400000,45100000,296300000,51700000,25900000,25800000,31600000,41800000,1836800000,863200000,338200000,None,4500000,4500000,973600000,None,450100000,None,445600000,450100000,520500000,196600000,1263500000,332600000,1619000000,76900000,91934000,BC
2015-03-31,USD,3030000000,1667000000,368200000,426000000,679800000,473700000,899100000,463900000,847300000,340200000,44200000,296000000,82900000,25100000,57800000,40900000,42500000,1832800000,845300000,347400000,None,5000000,5000000,987500000,None,457600000,5000000,448800000,457600000,15500000,193600000,1197200000,293500000,1512700000,76900000,92716000,BC
2014-12-31,USD,3130500000,1967800000,552700000,635900000,652300000,386500000,702400000,460300000,844100000,342400000,45500000,296900000,102200000,19000000,83200000,39500000,37500000,1959000000,900100000,317400000,None,5500000,3900000,1058900000,None,451800000,5500000,446300000,455700000,519500000,203000000,1171500000,287200000,1467300000,76900000,92694000,BC
2014-09-30,USD,3065100000,1895200000,596000000,596800000,668800000,401300000,728700000,441200000,852500000,345800000,46800000,299000000,40700000,39900000,800000,31200000,35900000,1785900000,863500000,326100000,None,4300000,4000000,922400000,None,452600000,4300000,448300000,456600000,18100000,203800000,1279200000,273300000,1483200000,76900000,92943000,BC
2014-06-30,USD,3030800000,1659300000,334200000,335000000,646100000,451400000,932700000,438800000,861500000,344400000,47000000,297400000,122100000,42300000,800000,33400000,35100000,1844100000,883800000,345700000,None,5000000,5000000,960300000,None,453900000,5000000,448900000,458900000,519800000,184400000,1186700000,280600000,1390300000,76900000,92749000,BC
2014-03-31,USD,2945700000,1559800000,226000000,226800000,661500000,459500000,962800000,423100000,860000000,326600000,34900000,291700000,124100000,44100000,800000,30000000,38200000,1852400000,867500000,360500000,None,5700000,5700000,984900000,None,459200000,5700000,453500000,459200000,478400000,185700000,1093300000,281900000,1311100000,76900000,92716000,BC
2013-12-31,USD,2915800000,1508600000,356500000,369200000,583900000,345700000,987300000,419900000,852900000,327100000,35400000,291700000,120600000,41300000,12700000,31400000,37600000,1877400000,883100000,297600000,None,6400000,6400000,994300000,None,459800000,6400000,453400000,466200000,508700000,192300000,1038400000,293300000,1263300000,76900000,92409000,BC
2013-09-30,USD,2416900000,1402500000,326100000,348400000,562900000,392600000,610100000,404300000,883400000,327600000,36100000,291500000,145600000,41100000,22300000,25300000,37100000,2127600000,858100000,310700000,None,4600000,0,1269500000,None,464500000,4600000,459900000,464500000,525400000,193100000,289300000,353500000,691200000,76900000,90842000,BC
2013-06-30,USD,2390700000,1380600000,327500000,330200000,548700000,423400000,416700000,593400000,1134600000,327000000,36700000,290300000,126600000,41700000,2700000,28700000,48000000,2177200000,877000000,333000000,None,6000000,6000000,1300200000,None,471600000,5200000,466400000,477600000,17000000,198000000,213500000,366600000,633400000,76900000,90506000,BC
2013-03-31,USD,2444100000,1411400000,242000000,276700000,604800000,471700000,454600000,578100000,1141800000,327900000,37400000,290500000,186500000,71400000,34700000,26500000,55300000,2313500000,900700000,376900000,None,6800000,900000,1412800000,None,568800000,5900000,562900000,569700000,10400000,201500000,130600000,370500000,553000000,76900000,90421000,BC
2012-12-31,USD,2424200000,1360100000,284300000,376600000,575800000,349200000,482700000,581400000,1131400000,329800000,38100000,291700000,267400000,94500000,92300000,26700000,58400000,2346500000,937200000,334400000,None,8200000,1700000,1409300000,None,570100000,6500000,563600000,571800000,547800000,197500000,77700000,388100000,503200000,76900000,90100000,BC
2012-09-30,USD,2507900000,1460700000,310300000,407800000,534100000,403800000,491800000,555400000,1130400000,331100000,39700000,291400000,268900000,89900000,97500000,61100000,59800000,2322100000,908000000,332200000,None,6800000,1800000,1414100000,None,595900000,5000000,590900000,597700000,564000000,195400000,185800000,390500000,583000000,76900000,89800000,BC
2012-06-30,USD,2571500000,1506100000,366000000,462400000,495700000,435800000,508200000,557200000,1114300000,331500000,41400000,290100000,266700000,88800000,96400000,61100000,63100000,2413100000,898000000,315500000,None,7100000,1600000,1515100000,None,673700000,5500000,668200000,675300000,569300000,191700000,158400000,392600000,580900000,76900000,89700000,BC
2012-03-31,USD,2532000000,1442900000,307100000,371000000,522300000,440800000,528900000,560200000,1166300000,333700000,42500000,291200000,248600000,102800000,63900000,59400000,67400000,2449600000,890900000,332700000,None,7300000,1200000,1558700000,None,694800000,6100000,688700000,696000000,542700000,192200000,82400000,394400000,497400000,76900000,89500000,BC
2011-12-31,USD,2494200000,1356300000,338200000,414900000,501500000,329600000,572000000,565900000,1211000000,333800000,43500000,290300000,304800000,140600000,76700000,62400000,72300000,2463300000,908100000,276600000,None,2400000,900000,1555200000,None,691900000,1500000,690400000,692800000,577900000,187800000,30900000,397500000,457700000,76900000,89300000,BC
2011-09-30,USD,2577800000,1434400000,384500000,458600000,529000000,389000000,562400000,581000000,1244800000,342100000,51100000,291000000,301100000,142000000,74100000,57800000,78300000,2388400000,902600000,302000000,None,2100000,2100000,1485800000,None,702700000,1500000,701200000,701200000,598500000,193800000,189400000,398000000,491800000,76900000,89400000,BC
2011-06-30,USD,2792000000,1630200000,527000000,605800000,527300000,447200000,557900000,603900000,1265500000,346000000,52900000,293100000,294400000,126800000,78800000,49900000,85100000,2581600000,967900000,324700000,None,1700000,1700000,1613700000,None,786700000,None,785200000,785200000,641500000,206200000,210400000,398400000,487100000,76900000,89300000,BC
2011-03-31,USD,2723400000,1565600000,424000000,500800000,550800000,469200000,541900000,615900000,1254600000,347300000,54800000,292500000,269800000,104100000,76800000,44800000,90500000,2600000000,957600000,339300000,None,1800000,1800000,1642400000,None,809900000,None,809900000,809900000,616500000,207000000,123400000,399300000,417800000,76900000,89100000,BC
